{
  "id": "map.plains.eldermill",
  "name": { "en": "Eldermill" },
  "type": "town",
  "tileSize": 16,
  "tiles": [
    [1, 1, 1, 1, 1, 1, 1, 1, 1, 1, 1, 1, 1, 1, 1, 1, 1, 1, 1, 1],
    [1, 5, 5, 5, 5, 5, 5, 5, 5, 5, 5, 5, 5, 5, 5, 5, 5, 5, 5, 1],
    [1, 5, 1, 1, 1, 5, 5, 5, 5, 5, 5, 5, 5, 5, 1, 1, 1, 1, 5, 1],
    [1, 5, 1, 0, 1, 5, 5, 4, 4, 4, 4, 4, 5, 5, 1, 0, 0, 1, 5, 1],
    [1, 5, 1, 0, 2, 5, 5, 4, 5, 5, 5, 4, 5, 5, 1, 0, 0, 1, 5, 1],
    [1, 5, 1, 1, 1, 5, 5, 4, 5, 5, 5, 4, 5, 5, 1, 0, 2, 1, 5, 1],
    [1, 5, 5, 5, 5, 5, 5, 4, 5, 5, 5, 4, 5, 5, 1, 1, 1, 1, 5, 1],
    [1, 5, 5, 5, 5, 5, 5, 4, 5, 5, 5, 4, 5, 5, 5, 5, 5, 5, 5, 1],
    [1, 5, 5, 5, 5, 5, 5, 4, 4, 2, 4, 4, 5, 5, 5, 5, 5, 5, 5, 1],
    [1, 5, 5, 5, 5, 5, 5, 5, 5, 4, 5, 5, 5, 5, 5, 5, 5, 5, 5, 1],
    [1, 5, 5, 5, 5, 5, 5, 5, 5, 4, 5, 5, 5, 5, 5, 5, 5, 5, 5, 1],
    [1, 5, 1, 1, 1, 5, 5, 5, 5, 4, 5, 5, 5, 5, 1, 1, 1, 1, 5, 1],
    [1, 5, 1, 0, 1, 5, 5, 5, 5, 4, 5, 5, 5, 5, 1, 0, 0, 1, 5, 1],
    [1, 5, 1, 0, 2, 5, 5, 5, 5, 4, 5, 5, 5, 5, 2, 0, 0, 1, 5, 1],
    [1, 5, 1, 1, 1, 5, 5, 5, 5, 4, 5, 5, 5, 5, 1, 1, 1, 1, 5, 1],
    [1, 5, 5, 5, 5, 5, 5, 5, 5, 4, 5, 5, 5, 5, 5, 5, 5, 5, 5, 1],
    [1, 5, 5, 5, 5, 5, 5, 5, 5, 4, 5, 5, 5, 5, 5, 5, 5, 5, 5, 1],
    [1, 1, 1, 1, 1, 1, 1, 1, 1, 4, 1, 1, 1, 1, 1, 1, 1, 1, 1, 1]
  ],
  "defaultSpawn": "spawn.center",
  "spawns": [
    { "id": "spawn.center", "pos": [9, 10] },
    { "id": "spawn.from_north", "pos": [9, 16] },
    { "id": "spawn.inn", "pos": [3, 4] },
    { "id": "spawn.smith", "pos": [16, 13] },
    { "id": "spawn.shop", "pos": [16, 5] }
  ],
  "exits": [
    {
      "id": "exit.south_field",
      "rect": [9, 17, 1, 1],
      "to": { "mapId": "map.plains.field_north", "marker": "spawn.from_eldermill" }
    }
  ],
  "npcs": [
    { "npcId": "npc.mayor_talvin", "spawn": [9, 8] },
    { "npcId": "npc.marn", "spawn": [16, 5] },
    { "npcId": "npc.brann", "spawn": [16, 13] },
    { "npcId": "npc.jonas", "spawn": [3, 4] }
  ],
  "monsters": [],
  "indoor": false
}
